111111111111111111111
100000000000000000001
100000000000000000001
100000000000000000001
100010000000000100001
100000100000010000001
100100000000000100001
100000001110000000001
100000000100000000001
100000001110000000001
100000000100000000001
100000000000000000001
100000000000000000001
100000000000000000001
111111111111111111111
